11111111111111111111111
10001000000010000000101
11101110111011101110101
10001000101010001000101
10111011101010111011101
10001000101000101010001
11101010101111101011101
10101010100000000000001
10101010111011111111101
10001010001010000010001
10111111101110111011111
10100000100000001010001
10101110111111111010101
10100010000000001000101
10111011111111101111101
10001010001000100010001
11101010101010111010101
10000010100010000000101
11111111111111111111111