1111111111111111111111111111111111111111111111111
1000001000000000000010000010000010100000000000101
1010101110111111111010111110101010101111101110101
1010100000100000000010000000101000100000100010001
1010111111101111111110111111101111111110111011101
1010100010001000001010001000100000000000100010101
1010111010111010101011101110111111111111101110101
1010100010001010100010001000000010000010101000001
1010101111101010111010111011111010111010101111101
1000100000101010001010100010000010001000100000101
1111101110101011101110101110111111101111111110101
1000001010001010100010100010000000100000001000101
1011111011111010111010111011111110111110111011101
1010100000001000001010000010000010001000100010001
1010101111101111101011111111111011101010101111101
1010001000001000001010000000000000100010100000101
1011111011111011111010111110111111111011111110101
1000001000001010001010100010000000000010000010101
1111101011101010101010101011111111111110111010101
1000001010101010101000001000000000100000100010101
1011111010101011101111111111111110101111101110111
1010000010101010000000100010000000100000101000001
1010111110101010111011101011111011111110101111101
1010000000101000101010001000001000100010101000101
1011111011101111101010111111101110101010101010101
1010000010001000000010100000101000101000100010001
1010111110101011111110101011101011101111111111101
1010000010101000100000101010001010101010000010001
1011111010111011101111101110111010101010101110111
1000001010000010001010000000100000101000100000101
1111101011111110111010111111111111101111101111101
1010001000000010100000100000000000100000101000001
1010111111111110101111101111111110101110101110101
1010100000000010100010001000001000101000100010101
1010101011111010111011101011101011111011111010101
1000101000100010101000001000101000100010001010101
1011101110101110101111111010111110101111101011101
1010001000101000100010000010001000101000001000101
1011111011101110101010111111101011101011111110101
1000000010000000101000000000100000001000000000001
1111111111111111111111111111111111111111111111111