111111111111111111111111111111111111111111111111111111111
100010000010000000001000000000000000001000000000100000001
101111101010111011101111101011111111101011101111101110101
100000001010101000101000101010000000101000100000101010101
111111111010101110101010101010101111101110111110101010111
100000100010000010100010101010101000100010000010001010001
101110101111111110111110111010111010111011111011111011101
101000100000100000100010001010000010000010001010000000101
101111111110101111101011101010111111111111101011111110101
101000100010001010001000100010101000100000001010000000101
101010101011111010111011111110101010101010111010111111101
100010101000000010101000001000100010001010100000100010001
101110101011101110101110101011111111101110101111101010101
100010101010001000101000101010000000101000101000101000101
111010101010111011101011111010111110111010101010101111111
101010001010101010001000000010100010100010101010100000001
101011111010101011101111111110111010101111101010111110101
100010100010101000000010000010001000100000001010000010101
101110101110101111111011111010101110111111111011111011101
101000101000000010001000001010100010001000000010001000001
101010101111111110101111101010111011101011111110111111101
101010101000000010100000001000101010001010100010000010001
101110101011111010111111111011101010111010101010111010111
101000101010001000100010000010001010000010001010100010101
101011101010111111111010111110101011101111101010101010101
101000100010000000000010001000101000101000101000101010001
101110111111111010111111101010101110111010111110101111101
100000100000001010000010001010100010000010000010100000101
111110111011101111111010111110111011111111111010111011101
100010001000101000001000100000101000100010001010001010001
101111101110101011101011101111101110101110101011111010111
101000101000100010001000001000100000101000101000001000001
101010101011111110111111111011101111101011101011101111111
101010100010001000100010000000001000001010001000100000001
101010111110101011101011111110111011101010111111101111101
100010000000101010001000100010001010101010000000100010001
101111101111101011101110101011101010101011111110111110101
100010100010001000100010001010100010001010000010100010101
111010111011111110111011111010101111111010111010101010101
101000001000100010000010001010001000001000100010101000101
101111101110101011111111101011111011101110101110101111111
100000100010001000000000001000000010100010101010100000001
101011111011111011111111101111111110111010101010111110101
101010001010000010000000101000100010000010101010000010101
101010101010111011111011101011101010111111101011111011101
101000101010001010001010001000101010000010001000001000001
101111101011101110101010111110101011111010111110111111101
101010001010100010101000000010001010000010100000100000101
101010111010111010101111111011111010111110101110101011101
101010000000100010100010000000000010000000101000101000001
101011111111101010111010111111111111111111101111101111111
100010000010001010100010100000000000001010000000001010001
111011111010111010101111101111111110101010111111111010101
101000001010100010101000001000000000100010000010000000101
101111101010111110101011111011101111111111111011111111101
101000001010001000101000100010001000001000100010000000001
101011111011101011101110101111111011101010101110111111101
100000000000100000100000100000000000100010000000100000001
111111111111111111111111111111111111111111111111111111111