1111111111111111111111111111111111111
1000001000100000000010000000000000001
1011101011101111101110101111111111101
1010001000001000100000100000001000101
1110111011111011111111111111101010101
1010001000001000001000000010001010001
1011101111101110111010111110111011111
1000100010000010000010001000101000101
1011111011111011111111101011101110101
1000001000001000001000101000100000101
1110101111101111101010101110101111101
1000100000101000100010000010100010001
1011111111101010101111111110111011101
1010000010001010101000000010100000001
1010111010111010111011111010111111111
1010101000100010100010000010000010001
1010101111101010101110111111101010101
1010000010001010001010100000101000101
1011111010111011111010101110101111101
1000000010100010000010001010101010001
1011111110101110101111111010101010101
1010000000101010100000000000100010101
1010111111101010111111111111111110101
1010100000001000100000000000001000101
1011101111111011111110101111101011101
1000001000001000100010100000101000101
1111111011101110101011111110101110101
1000000000100000001000000000100000101
1111111111111111111111111111111111111