1111111
1000001
1011101
1000001
1011111
1000001
1111101
1000101
1010101
1010101
1011101
1000101
1010101
1010001
1011111
1010001
1010111
1010001
1011101
1000101
1110101
1010101
1010101
1010101
1010101
1000101
1011101
1010001
1010101
1010101
1010111
1010001
1011101
1000101
1110101
1010101
1010101
1000101
1011101
1000101
1110101
1000001
1111111