111111111111111111111111111111111111111
100010000010000000000000000000001000001
101010101011111111111111101111101010101
101010101010000000100000001000101010101
101011101010111110101111111010101110101
100000001000100000001000000010000000101
111111111111111111111111111111111111111