11111111111111111111111111111
10000000101000000000000010001
10111110101011101111111011101
10000010100000100000001000101
10111110111110111111101110101
10000010000010001000100010001
10111011111010111010111011101
10101000001010100010000010001
10101111101011101111111110111
10001010001010001000000010101
11101010111010111011111110101
10000010000000100000000000001
11111111111111111111111111111